####################
#                  #
#  t     T     t   #
#                  #
#                  #
#                  #
#                  #
#                  #
#                  #
#                  # 
#                  #
#                  #
#                  #
#                  #
#                  #
#                  #
#                  #
#  t     T     t   #
#                  #
####################
